"filename", "language", "Python", "pip requirements", "Markdown", "JSON", "comment", "blank", "total"
"/home/cebo/Desktop/Projects/notions/notions/__init__.py", "Python", 0, 0, 0, 0, 0, -1, -1
"/home/cebo/Desktop/Projects/notions/notions/config.json", "JSON", 0, 0, 0, -1, 0, 0, -1
"/home/cebo/Desktop/Projects/notions/notions/constants.py", "Python", -11, 0, 0, 0, 0, -5, -16
"/home/cebo/Desktop/Projects/notions/notions/helpers.py", "Python", -56, 0, 0, 0, -6, -30, -92
"/home/cebo/Desktop/Projects/notions/notions/models/notion_props.py", "Python", -42, 0, 0, 0, 0, -15, -57
"/home/cebo/Desktop/Projects/notions/notions/notion_crud.py", "Python", -87, 0, 0, 0, -3, -32, -122
"/home/cebo/Desktop/Projects/notions/notions/notions.py", "Python", -138, 0, 0, 0, -3, -33, -174
"/home/cebo/Desktop/notion-cli/README.md", "Markdown", 0, 0, 0, 0, 0, 1, 1
"/home/cebo/Desktop/notion-cli/__main__.py", "Python", 4, 0, 0, 0, 0, 1, 5
"/home/cebo/Desktop/notion-cli/data/cached_data.json", "JSON", 0, 0, 0, 10, 0, 0, 10
"/home/cebo/Desktop/notion-cli/requirements.txt", "pip requirements", 0, 6, 0, 0, 0, 1, 7
"/home/cebo/Desktop/notion-cli/setup.py", "Python", 20, 0, 0, 0, 3, 6, 29
"/home/cebo/Desktop/notion-cli/src/__init__.py", "Python", 0, 0, 0, 0, 0, 1, 1
"/home/cebo/Desktop/notion-cli/src/cli.py", "Python", 21, 0, 0, 0, 1, 11, 33
"/home/cebo/Desktop/notion-cli/src/commands/cmd_charts.py", "Python", 63, 0, 0, 0, 12, 30, 105
"/home/cebo/Desktop/notion-cli/src/commands/cmd_export.py", "Python", 11, 0, 0, 0, 0, 8, 19
"/home/cebo/Desktop/notion-cli/src/commands/cmd_notion.py", "Python", 92, 0, 0, 0, 18, 39, 149
"/home/cebo/Desktop/notion-cli/src/commands/cmd_sync.py", "Python", 6, 0, 0, 0, 2, 5, 13
"/home/cebo/Desktop/notion-cli/src/config.py", "Python", 3, 0, 0, 0, 1, 4, 8
"/home/cebo/Desktop/notion-cli/src/constants.py", "Python", 17, 0, 0, 0, 0, 6, 23
"/home/cebo/Desktop/notion-cli/src/helpers.py", "Python", 90, 0, 0, 0, 5, 42, 137
"/home/cebo/Desktop/notion-cli/src/models/notion_props.py", "Python", 40, 0, 0, 0, 1, 17, 58
"/home/cebo/Desktop/notion-cli/src/services/notion_svc.py", "Python", 216, 0, 0, 0, 20, 73, 309
"Total", "-", 249, 6, 0, 9, 51, 129, 444